$     $     $
 + + + + + + 
*+ + + + + + 
*+ +*+#+ + + 
*  **+ + ****
+ ++**  *++*+
#~~~~+ +    #
 ~~+~+ + +   
 +~+~+++ + + 
*+ +*+*+ + + 
*+ +**@* + + 
 + +*+++ + + 
   **+!+     
11111111111111111111
