$  #  $#    $
 + #   + + + 
 +    ++ +#+ 
   +     #   
*  +  #+ +*+#
**   +  # *  
 +++***#  *+ 
   #*+ + + + 
#+ # +++   + 
 + + +++ +#+ 
 + +  @      
 +   +++ + + 
 + + +!+ +++ 
44111111111111111111
