$  #  $~~   $
 + #      +  
 +  $ +~~~#+ 
   +~ ~  #   
*  +~~#+ +*+#
**  ~~  # *  
 +++~~*# $*+ 
   #~~ + + + 
#+ #~+++   + 
 + ~~+++ +#+ 
 +    @      
 +~~~+++ + + 
 +~~~+!+ +++ 
HSSssssHHHsssSHHss
